1111111111
1000000001
1040000601
1000000001
1050000301
1000200001
1111111111