1100000011
1040404041
0606060606
6060606060
0606060606
1040404041
1100000011