1111111111
1400001021
1000101001
1006151001
1003111001
1000000001
1111111111