1111111111
1500130041
1030100301
1110201111
1300100301
1603130061
1111111111