1111111111
1063030041
1030000331
1200100001
1030003301
1063003501
1111111111