1111111111
1666666661
1656665661
1665656661
1666566661
1666666661
1111111111