1111111111
1000000001
1020100601
1111100001
1000001301
1040001051
1111111111