1111111111
1600000001
1020100001
1111100001
1000001301
1040001051
1111111111