1111111111
1666666661
1626662661
1662626661
1666266661
1666666661
1111111111