1111111111
1666666661
1636663661
1663636661
1666366661
1666666661
1111111111